 ##     # 
  # #  ## 
#   ##    
    ## # #
# #  # # #
# ##      
     # ## 
 ## ## ## 
 #    #   
   ##   # 