  ##      
     # ## 
## ##   # 
 #    #   
   ##   # 
  ##      
     # ###
## ##   # 
 #    #   
   ##   # 