 ## ##  # 
  #    ## 
#   ##    
    ## # #
# #  # # #
# ##      
     # ## 
 ## ## ## 
 #        
   ### ## 